@@@###@@@###@@@####@@@@@@
@@@@@@@@$@@@@@@@@@@@@@@@@
#########################
@@@@@@@$@@@@@@@@@@@@$@@@@
@@@@@@@@@@@@$@@@@@@@@@@@@
@@@@@$@@@@@@@@@@@@@@@@@@@


     *            *
